R 750 500

F 153, 42, 6
C 65, 25, 9

NO hello
SO bonjour
WE salut
EA coucou
S hey

111111111
100000001
100000001
100000001
101000001
100000001
100000001
1000N0001
111111111