R 4000 4000
C 25, 25, 25
F 63, 63, 63

NO hello
SO bonjour
WE salut
EA coucou
S hey

1111111111
101  1111
111  111S11111
1011111001
1111111111